main
::MAPDATA::
census_room 6 2 main
::MAPDATA::
  ---------
  |       |
  |   o   |
  |_______|

